WE image/bluestone.xpm
EA image/eagle.xpm
SO image/redbrick.xpm
NO image/purplestone.xpm

F 154,117,45

C 135,206,235


11111111111111111111111111111111111111111111111111111111111111111111111111
1E0000000000000000000000000000000000000000000000000000000000000000000000001
10000000000000000000000001111111111111111111111111111111111111111111111111111
100000000000000000000000000000000000000000000000000000000000000000000000001
10000000000000000000000001111111111111111111111111111111111111111111111111111
100000000000000000000000000000000000000000000000000000000000000000000000001
10000000000000000000000001111111111111111111111111111111111111111111111111111
100000000000000000000000000000000000000000000000000000000000000000000000001
10000000000000000000000001111111111111111111111111111111111111111111111111111
100000000000000000000000000000000000000000000000000000000000000000000000001
10000000000000000000000001111111111111111111111111111111111111111111111111111
100000000000000000000000000000000000000000000000000000000000000000000000001
10000000000000000000000001111111111111111111111111111111111111111111111111111
100000000000000000000000000000000000000000000000000000000000000000000000001
10000000000000000000000001111111111111111111111111111111111111111111111111111
100000000000000000000000000000000000000000000000000000000000000000000000000001
10000000000000000000000001111111111111111111111111111111111111111111111111111
1111111111111111111111111